1111111111111111
10010000000C0011
1000011111000011
1P0011E000001001
1000010011100101
1111111111110001
